###########
#....#....#
#.##.#.##.#
#.##.#.##.#    #
#.........#    #
###.###.###    #
###.....###    #
   .# #.     #####
###.# #.###  ## ##
###.###.###
#.........#
#.##.#.##.#
#.##.#.##.#
#..p.#....#
###########