###########
#....#....#   # #
#.##.#.##.#    #
#.##.#.##.#    
#.........#    #
###.###.###    #
###.....###    #
   .# #.       #
###.# #.###  #####
###.###.###  ## ##
#.........#
#.##.#.##.#
#.##.#.##.#
#..p.#....#
###########